NO textures/N_image.xpm
SO textures/S_image.xpm
WE textures/W_image.xpm
EA textures/E_image.xpm

F 220,100,0
C 225,30,0


111111111111111111111111111
100000000011000000000111111
111101000000000001000000101
111100000000000000010100101
110000000000000000000000101
100000000000000001000000101
100000000000000001010100101
110000000001010001110000001
11110000000000N001111010001
111111111111111111111111111