NO textures/N_image.xpm
SO textures/S_image.xpm
WE textures/W_image.xpm
EA textures/E_image.xpm

F 214,196,153
C 119,181,254


111111111111111111111111111
100000000011000000000111111
111101000000000001000000101
111100000000000000010100101
110000000000000000000000101
100000000000000001000000101
100000000000000001010100101
110000000001010001110000001
10000000000000N001111010001
111111111111111111111111111