NO ./path_to_the_north_texture 
SO ./path_to_the_south_texture 
WE ./path_to_the_west_texture 
EA ./path_to_the_east_texture


F 200,0,0 
C 0,0,0




        1111111111111111111111111
        1000000000110000000000001
        1011000001110000000000001
        1001000000000000000000001
        1001000000000000000000001
111111110011000001110000000000001
100000111011000011110111100111111
111101 111111101 1111111111
111101111111111
1100000011010101 111111111111
1000000000000001 100000000001
1000000000000001 101010010001
1100000111010101 111011110N0111
11110111 1110101 101111010001
11111111 1111111 1111111111111
