NO maps/N_image.xpm
SO maps/image.xpm
WE maps/W_image.xpm
EA maps/E_image.xpm

F 0,106,15
C 119,181,254

        1111111111111111111111111                
        1000000000110000000000001
        1011000001110000000000001
        10010000000000000000N0001
        1001000000010000000000001
111111111011000001110000000000001
100000000011000011111111100111111
1111011111111101 100000011111
111101111111111   11010010001
1100000011010101 100000010001
10000000000000001000000010001
10000000000000001001010010001
11000001110100000000000010001
11110111 11101000001111010001
11111111 111111111111111111111

