NO ./path_to_the_north_texture 
SO ./path_to_the_south_texture 
WE ./path_to_the_west_texture 
EA ./path_to_the_east_texture

F 0,0,0
C 1,1,1

        1111111111111111111111111
        1000000000110000000000001
        1011000001110000000000001
        1001000000000000000000001
        1001000000000000000000001
111111111011000001110000000000001
100000000011000011110111100111111
1111011111111101 100000010001
111101111111111   11010010001
1100000011010101 100000010001
10000000000000001100000010001
10000000000000001101010010001
11000001110101011111011110N0111
11110111 11101011101111010001
11111111 111111111111111111111

