NO maps/1wood.xpm
SO maps/2wood.xpm
WE maps/3wood.xpm
EA maps/wall-wood-.xpm

F 160,108,30
C 119,181,254


111111111111111111111111111
100000100000100000100000001
100000100000100000100000001
100000100000111111100000011
111111100000100000100000001
100000000000100000100000001
100000000000111111100111111
100000000000000000000100001
100000000000000000000100N01
111111111111111111111100001
                    1111111