NO maps/1wood.xpm
SO maps/2wood.xpm
WE maps/3wood.xpm
EA maps/wall-wood-.xpm


F 160,108,30
C 119,181,254


1111111111111111111111111111111111111111111111111111111111111111111111111111111111111111111111111
10000001000000000000000000000000000000000000000000000000000000000000000000000000000000000000000001
1000000100000000000000000000000000000000000000000000000000000000000000000000000000000000000000001
1000S00100000000000000000000000000000000000000000000000000000000000000000000000000000000000000001
10000000100000000000000000000000000000000000000000000000000000000000000000000000000000000000000001
10000000010000000000000000000000000000000000000000000000000000000000000000000000000000000000000001
1111111111111111111111111111111111111111111111111111111111111111111111111111111111111111111111111