NO maps/1wood.xpm
SO maps/2wood.xpm
WE maps/3wood.xpm
EA maps/4wood.xpm


F 160,108,30
C 119,181,254


11111111111111111111111111111111111111
1000S001000000001000000000000000000001
10000001000000001000000000000000000001
10000001000000001000000000000000000001
11111111000000001111111111111111111111
100000000000000000000000000000000001
10000000000000000000000000000000001111
1111111111111111111000000000000000001
100000000000000000100000000000000000111
1000000000000000001000000000000000000001
11111111111111111111111111111111111111111
