NO maps/1wood.xpm
SO maps/2wood.xpm
WE maps/3wood.xpm
EA maps/wall-wood-.xpm


F 160,108,30
C 119,181,254


1111111111111111111111111111111111111111
1000S00100000000100000001000000000000011
1000000100000000100000001000000000000011
100000010000000010000000100000000000001
11111111000000001000000001000000000001
1000000000000000111000000100000000111
10000000000000001  100001000000001
10000000000000001  10000100000000011
100000000000000011 1111110000000000011
1000000111111111111 10000000000000000011
1000001              10000000000000000001
100000011            100000000000000000001
111111111111111111 1111111111111111111111
