NO maps/1wood.xpm
SO maps/2wood.xpm
WE maps/3wood.xpm
EA maps/wall-wood-.xpm


F 160,108,30
C 119,181,254


1111111111111111111111111111111
1000S00100000000000000000000011
1000000100000000000000000000011
1000000100000000000000000000001
11111111000000000000000000000001
10000000000000000000000000000011
1000000000000000000000000000001
1000000000000000000000000000001
1000000000000000000001111111111
1000000000000000000001000000001
1000000000000000000001000000001
11111111111111111111111111111111