NO maps/N_image.xpm
SO maps/N_image.xpm
WE maps/wall-wood-.xpm
EA maps/wall-wood-.xpm

F 171,171,171
C 130,0,20


111111111111111111111111111
100000100000000000000000001
10N000100000000000000000001
100000100000000000000000111
111111000000000000000000001
100000000000000000000000001
100000000000000000000000001
100000000000000000000000001
100000000000000000000000001
111111111111111111111111111